622222222222222222222222222222222222222222222222222222222222222222222222222222222222222222222222222222222222222222222225 
1GGGG0000000000000000000000000000000000000000000000000000000000000000000000000000000000000000000000000000000000000000001 
1GGGG0000000000000000000000000000000000000000000000000000000000000000000000000000000000000000000000000000000000000000001 
1HHHH0000000000000000000000000000000000000000HH0000000000000000000000000000000000HHHHHHHHHHHH000000000000000000000000001 
1000000000000000000000000000000000000000000000H000000000000000000000000000000000000000000000H000000000000000000000000001 
1000000000000000000000000000000000000000000000H000000000000000000000000000000000000000000000H000000000000000000000000001 
10000000000000000000000000000HHHHHHHHHHHHHHHH0H000000000000000000000000000000000000000000000H000000000000000000000000001 
1000000000000000000000000000000000000000000000H000000000000000000000000000000000000000000000H000000000000000000000HHHHH1 
1000000000000000000000000000000000000000000000H000000000000000000000000000000000000000000000H000000000000000000000GGGGG1 
1000000000000000000000000000000000000000000000H0000000000000000000000000000000000000000000000000000000000000000000GGGGG1 
100000000000000HHHHHHHHHHHHHH00000000000000000H0000000000000000000000000000000000000000000000000000000000000000000HHHHH1 
1000000000000000000000000000000000000000000000H000000000000000000HHHHHHHHHHHHHHHH000000000000000000000000000000000000001 
1000000000000000000000000000000000000000000000H0000000000000000000000000000000000000000000000000000000000000000000000001 
1000000000000000000000000000000000000000000000H0000000000000000000000000000000000000000000000000000000000000000000000001 
10000000000000000000000000000000HHHHHHHHHHHHHH00000000000000000000000000000000000000000000000000000000000000000000000001 
100000000000000000000000000000000000000000000000000000000000000000000000000000000000000000000H00000000000000000000000001 
100000000000000000000000000000000000000000000000000000000000000000000000000000000000000000000H00000000000000000000000001 
1000000000000000000000000000000000000000000000HHHHHHHHHHHHHHHHHHH0000000000000000000000000000H00000000000000000000000001 
1HHHHH000000000000000000000000000000000000000000000000000000000000000000000000000000000000000H000000000000000000HHHHHHH1 
1GGGG0000000000000000000H00000000000000000000000000000000000000000000000000000000000000000000H00000000000000000000GGGGG1 
1GGGG0000000000000000000H000000000000000000000H0000000000000000000000000000000000000000000000H00000000000000000000GGGGG1 
1HHHH0000000000000000000H000000000000000000000H000000000000000000000000000000000000000000000000000000000000000000HHHHHH1 
100000000000000000000000H000000000000000000000H0000000000000000000000000000000000000000000000H00000000000000000000000001 
100000000000000000000000H00000000000000000000000000000000000000000HHHHHHHHHHHHHHHHHHHHHH00000000000000000000000000000001 
100000000000000000000000H00000000000000000000000000000000000000000000000000000000000000000000000000000000000000000000001 
100000000000000000000000H0000000000000000HHHHHHHHHHHHHH00000000000000000000000000000000000000000000000000000000000000001 
100000000000000000000000000000000000000000000000000000000000000000000000000000000000000000000000000000000000000000000001 
10008000000000000000000000000000000000000000000000000000000000HHHHHHHHHHHH0000000000000000000000000000000000000000000001 
100000000000000000000000000000000000000000000000000000000000000000000000000000000000000000000000000000000000000000000001 
322222222222222222222222222222222222222222222222222222222222222222222222222222222222222222222222222222222222222222222224 

