6222222222222222222F222222222F222222222222222222222222222222222222222222222222222222222222222222222222222222222222222225 
1000000000000000000100000000010000000000000000000000000000H000000000000000000000H000000000000000000000000000000000000001 
1000000000000000000100000000010000000000000000000000000000H000000000000000000000H000000000000000000000000000000000000001 
1006222222222222500100000000010000000000000000000000000000H0000000000HHHHHHHHHHHHHHHHHHHHHHHHH00000000000000000000000001 
1001000000000000100100000000010000000000000000000000000000H000000000000000000000H000000000000000000000000000000000000001 
10010000000000001001000000000A0000000000000000000000000000H000000000000000000000H0000000000000000000000000HHHHHH00000001 
1001000000000000A001000000000100000000000000002222225000000000000000000000000000H0000000000000000000000000H00000000HHHH1 
10010000000000001001000000000100000000000000000000001000000000000000000000000000H0000000000000000000000000H00000000GGGG1 
100100006222B22272B7222B22222722222200000000000000001000000000HHHH00000000000000H0000000000000000000000000H00000000GGGG1 
10010000100000001001000000000100000000000000000000001000000000HHHH0000000000000000000000000000000000000000H00000000HHHH1 
100A000010000000A001000000000100000000000000000000001000000000HHHH0000000000000000000000000000000000000000H0000000000001 
1001000010000000100100000000010000000000000000000000000000000000000000000000000000000000000000000000000000H0000000000001 
10032222722222224001000000000100000000000000000000000000000000000000000000000000000000000000000000000HHHHHHH000000000001 
10000000100000000001000000000C222222222250000000000002222222220000000000000000000000000000000000000000000000000000000001 
1000000010000000000A0000000001000000000010000000000000000000000000000000000000000000000000000000000000000000000000000001 
100000001000000000010000000001000000000010000000000000000000000000000000000000000000000000000000000000000000000000000001 
100000001000000000010000000001000000000010000000000000000000000000000000000000000000000000000000000000000000000000000001 
C22B2500100622222224000000000A0000000000100000000000000000000000000000000000HHHHHHHHHHHHHHHHHHHHHH0000000000000000000001 
1000010010010000000000000000010000000000100000000000000000000000000000000000H00000000000000000000H0000000000000000000001 
1000010010010000000000000000010000000000100000000000000000000000000000000000H00000000000000000000H0000000000000000000001 
100001001001000000000000000001000000000010000000HHHH000000000000000000000000H00000000000800000000H00000000000000000HHHH1 
32222D003B2E2222F2222222B222272222222B22400000000HHHH00000000000000000000000H00000000000000000000HHHH00000000000000GGGG1 
GGGGG1000000000010000000000002000000000000000000000HHHH000000000000000000000HH0000000000000000000000000000000000000GGGG1 
GGGGGA00000000001000000000000A000000000000000000000000000000000000000000000HHHH000000000000000000000000000000000000HHHH1 
GGGGG10000000000100000000000020000000000000000000000000000000000000000HHHHHHHHHHHHHHH00000000000000000000000000000000001 
62222E2250062222E222222250000200000000000000HHH00000000000000000000000HHHHHHHHHHHHHHHHHHHHHHHHHHHHHHHHHHHHHHHHHHHH000001 
10000000100A00000000000010000200000000000000HHH00000000000000000000000HHHHHHHHHHHHHHHHHHHHHHHHHHHHHHHHHHHHHHHHHHHH000001 
10009000100100000000000010000200000000000000HHH0000000000000000000000000000000000000000000000000000000000000000000000001 
10000000A001000000000000A00002000000000000000000000000000000000000000000000000000000000000000000000000000000000000000001 
32222222E22E222222222222E2222E222222222222222222222222222222222222222222222222222222222222222222222222222222222222222224 

