622222222222222222222222222222222222222222222222222222222222222222222222222222222222222222222222222222222222222222222225 
100000000000000000000000000000000000000000000H000000000000000H0000000000000000000H00000000000000000000000000000000000001 
10000000HHHH000000000000000000000000000000000H000000000000000H0000000000000000000H00000000000000000000000000000000000001 
10000000H000HHHHH0000000000000000000000000000H000000000000000A0000000000000000000A00000000000000000000000000000000000001 
10000000H00000000HHH0000000000000000000000000H000000000000000H0000000000000000000H00000000000000000000000000000000000001 
10000000H0000000000HH00000000000000H0000000000H00000000000000H0000000000000000000H0000000000000000000HHHHHHHHHHHH0000001 
10000000H00000000000H00000000000000H00000000000HHHHHBHHHHHHHHH000000000000000HHHH0000000000000000000000000000000HH000001 
1HHHH000000000000000H00000000000000H000000000000000000000000HHHHHHBHHHHHHHHHH000000000000000000000HHHHHHHH0000000HH00001 
1GGGG000000000000000H00000000000000H0000000000000000000000000000000000000000000000000000000000000000000HH00000000HH00001 
1GGGG000000000000000H00000000000000H00000000000000000000000000000000000000000000000000000000000000000000HH000000HH000001 
1HHHH000000000000000H000000000000000000000000000000000000000000000000000000000000000000000000000000000000HH00HHHH0000001 
10000000000000000000H0000000000000000000000000000000000000000000000000000000000000000000000000000000000000HHH00000000001 
1000000000000000000HHHHHHHHHHHHHHHH0000000000000000000000000000000000000000000000000000000000000000000000000000000HHHHH1 
100000000000000000000000000000000000000000000000000000000000000000000000000000000000000000000000000000000000000000GGGGG1 
10000000000000000000000000000000000000000000000000000000000000000000000000000000000HHHHHHHHH0000000000000000000000GGGGG1 
10000000000000000000000000000000000000000000000000000000000000000000000000000000000H000000000000000000000000000000HHHHH1 
1000000000000000000000000000000000000000H00000000000000000HHHH0000000000HHH00000000H000000000000000000000000000000000001 
1000000000000000000000000000000000000000H00000000000000000H000HHH000000000H00000000H00H000000000000000000000000000000001 
1000000HHHHHHHHHHHHH00000000000000000000H00000000000000000H000000HH0000000H00000000HHHHHHH000000000HHHHH0000000HHH000001 
1000000HHHHHHHHHHHHHH0000000000000000000H00000000000000000A00000000H000000H0000000H0000000H000000000000HHH000HHH00000001 
1000000000HHHHH0000000000000000000000000H00000000000000000H00000000H000000H0000000H00000900H00000000000000HHHH0000000001 
10000000000000HHH00000000000000000000000H00000000000000000H000000HH0000000H0000000H00000000H0000000000000000000000000001 
1000000000000000HHH000000000000000000000H00000000000000000H000HHH000000000H00000000H0000000H0000000000000000000000000001 
100000000000000000HH00000000000000000000HHHHHHHHHHHHHH0000HHHH000000HHHHHHHHHHHHH000HHHBHHH00000000000000000000000000001 
1000000000000HHHHHHHH000000000000000000000000000000000000000000000000000000000000000000000000000000000000000000000000001 
1000HHHHHHHH0HH000000000000000000000000000000000000000000000000000000000000000000000000000000000000000000000000000000001 
1HHHH000000000HH00000000000000000000000000000000000000000000000000000000000000000000000000000000000000000000000000HHHHH1 
1GGGG0000000000000000000000000000000000000000000000000000000000000000000000000000000000000000000000000000000000000GGGGG1 
1GGGG0000000000000000000000000000000000000000000000000000000000000000000000000000000000000000000000000000000000000GGGGG1 
322222222222222222222222222222222222222222222222222222222222222222222222222222222222222222222222222222222222222222222224 

